Gene	GTEx_status	Placenta_status
ABCB7	Inactivated	Inactivated
ABCD1	Inactivated	Inactivated
ACSL4	Inactivated	Inactivated
AF241726.2	Inactivated	Inactivated
AIFM1	Inactivated	Inactivated
AL034405.1	Inactivated	Inactivated
ALG13	Inactivated	Inactivated
AMOT	Inactivated	Inactivated
APLN	Inactivated	Inactivated
APOO	Inactivated	Inactivated
APOOL	Inactivated	Inactivated
ARAF	Inactivated	Inactivated
ARMCX3	Inactivated	Inactivated
ATP6AP1	Inactivated	Inactivated
ATP6AP2	Inactivated	Inactivated
BCORL1	Inactivated	Inactivated
BEX4	Inactivated	Inactivated
C1GALT1C1	Inactivated	Inactivated
CCDC120	Inactivated	Inactivated
CD99L2	Inactivated	Inactivated
CDKL5	Inactivated	Inactivated
CLCN5	Inactivated	Inactivated
COL4A5	Inactivated	Inactivated
CXorf40B	Inactivated	Inactivated
DIAPH2	Inactivated	Inactivated
DKC1	Inactivated	Inactivated
DLG3	Inactivated	Inactivated
ELF4	Inactivated	Inactivated
ELK1	Inactivated	Inactivated
FAM122B	Inactivated	Inactivated
FMR1	Inactivated	Inactivated
FTX	Inactivated	Inactivated
G6PD	Inactivated	Inactivated
GABRE	Inactivated	Inactivated
GDI1	Inactivated	Inactivated
GPKOW	Inactivated	Inactivated
GRIPAP1	Inactivated	Inactivated
HMGB3	Inactivated	Inactivated
HTATSF1	Inactivated	Inactivated
HUWE1	Inactivated	Inactivated
IDS	Inactivated	Inactivated
KLF8	Inactivated	Inactivated
LAGE3	Inactivated	Inactivated
LAMP2	Inactivated	Inactivated
MAGED1	Inactivated	Inactivated
MAGED2	Inactivated	Inactivated
MAGT1	Inactivated	Inactivated
MAOA	Inactivated	Inactivated
MAP7D2	Inactivated	Inactivated
MED12	Inactivated	Inactivated
MED14	Inactivated	Inactivated
MORC4	Inactivated	Inactivated
MORF4L2	Inactivated	Inactivated
MOSPD2	Inactivated	Inactivated
MPP1	Inactivated	Inactivated
MTM1	Inactivated	Inactivated
MTMR1	Inactivated	Inactivated
MUM1L1	Inactivated	Inactivated
NDUFB11	Inactivated	Inactivated
NONO	Inactivated	Inactivated
NRK	Inactivated	Inactivated
OPHN1	Inactivated	Inactivated
OTUD5	Inactivated	Inactivated
PCDH11X	Inactivated	Inactivated
PDHA1	Inactivated	Inactivated
PDK3	Inactivated	Inactivated
PHF8	Inactivated	Inactivated
PHKA2	Inactivated	Inactivated
PJA1	Inactivated	Inactivated
PLXNA3	Inactivated	Inactivated
RAP2C-AS1	Inactivated	Inactivated
RBBP7	Inactivated	Inactivated
RBM10	Inactivated	Inactivated
RBM3	Inactivated	Inactivated
RPL10	Inactivated	Inactivated
RTL8A	Inactivated	Inactivated
RTL8B	Inactivated	Inactivated
SAT1	Inactivated	Inactivated
SCML2	Inactivated	Inactivated
SHROOM2	Inactivated	Inactivated
SLC10A3	Inactivated	Inactivated
SLC16A2	Inactivated	Inactivated
SLC25A43	Inactivated	Inactivated
SLC25A5	Inactivated	Inactivated
SLC6A8	Inactivated	Inactivated
SMARCA1	Inactivated	Inactivated
SNX12	Inactivated	Inactivated
SOWAHD	Inactivated	Inactivated
STK26	Inactivated	Inactivated
TAF1	Inactivated	Inactivated
TBC1D25	Inactivated	Inactivated
TBL1X	Inactivated	Inactivated
TCEAL4	Inactivated	Inactivated
TFE3	Inactivated	Inactivated
TIMM17B	Inactivated	Inactivated
TMEM164	Inactivated	Inactivated
TREX2	Inactivated	Inactivated
TRMT2B	Inactivated	Inactivated
TSR2	Inactivated	Inactivated
UBE2A	Inactivated	Inactivated
UBL4A	Inactivated	Inactivated
VGLL1	Inactivated	Inactivated
WDR13	Inactivated	Inactivated
WDR44	Inactivated	Inactivated
WDR45	Inactivated	Inactivated
WWC3	Inactivated	Inactivated
XIAP	Inactivated	Inactivated
XKRX	Inactivated	Inactivated
ZBTB33	Inactivated	Inactivated
ZNF185	Inactivated	Inactivated
ZNF630	Inactivated	Inactivated
AKAP17A	Escape	Escape
ASMTL	Escape	Escape
ASMTL-AS1	Escape	Escape
CSF2RA	Escape	Escape
DDX3X	Escape	Escape
DHRSX	Escape	Escape
EIF2S3	Escape	Escape
GTPBP6	Escape	Escape
KDM5C	Escape	Escape
KDM6A	Escape	Escape
PLCXD1	Escape	Escape
PUDP	Escape	Escape
SLC25A6	Escape	Escape
STS	Escape	Escape
ZFX	Escape	Escape
CDK16	Variable_escape	Variable_escape
CHRDL1	Variable_escape	Variable_escape
EGFL6	Variable_escape	Variable_escape
MXRA5	Variable_escape	Variable_escape
SHROOM4	Variable_escape	Variable_escape
SYN1	Variable_escape	Variable_escape
ACOT9	Inactivated	Escape
CASK	Inactivated	Escape
TSC22D3	Inactivated	Escape
ARSD	Escape	Inactivated
PRKX	Escape	Inactivated
AL133500.1	Inactivated	Variable_escape
ATG4A	Inactivated	Variable_escape
ATRX	Inactivated	Variable_escape
BCOR	Inactivated	Variable_escape
CXorf56	Inactivated	Variable_escape
EFNB1	Inactivated	Variable_escape
GPC4	Inactivated	Variable_escape
HCFC1	Inactivated	Variable_escape
IL13RA1	Inactivated	Variable_escape
IRAK1	Inactivated	Variable_escape
LINC00632	Inactivated	Variable_escape
MBTPS2	Inactivated	Variable_escape
MSL3	Inactivated	Variable_escape
PLS3	Inactivated	Variable_escape
RBM41	Inactivated	Variable_escape
RPS6KA3	Inactivated	Variable_escape
SMS	Inactivated	Variable_escape
TAB3	Inactivated	Variable_escape
TSPAN6	Inactivated	Variable_escape
USP11	Inactivated	Variable_escape
VSIG4	Inactivated	Variable_escape
BGN	Variable_escape	Inactivated
CAPN6	Variable_escape	Inactivated
CHM	Variable_escape	Inactivated
DOCK11	Variable_escape	Inactivated
FAM50A	Variable_escape	Inactivated
FHL1	Variable_escape	Inactivated
GPC3	Variable_escape	Inactivated
GPRASP2	Variable_escape	Inactivated
HAUS7	Variable_escape	Inactivated
MAP7D3	Variable_escape	Inactivated
NLGN4X	Variable_escape	Inactivated
OFD1	Variable_escape	Inactivated
PIR	Variable_escape	Inactivated
PRRG1	Variable_escape	Inactivated
RTL8C	Variable_escape	Inactivated
SEPT6	Variable_escape	Inactivated
SH3KBP1	Variable_escape	Inactivated
STARD8	Variable_escape	Inactivated
USP9X	Variable_escape	Inactivated
CD99	Escape	Variable_escape
PIN4	Escape	Variable_escape
TXLNG	Escape	Variable_escape
ZRSR2	Escape	Variable_escape
ARHGAP4	Variable_escape	Escape
CXorf36	Variable_escape	Escape
FLNA	Variable_escape	Escape
SMC1A	Variable_escape	Escape
UBA1	Variable_escape	Escape
